NO ./textures/north.xpm
SO ./textures/south.xpm
WE ./textures/west.xpm
EA ./textures/east.xpm

F 25,25,25
C 200,200,200

11111111111
10000000001
10000000001
10000000001
10000000001
10000N00001
10000000001
10000000001
10000000001
10000000001
11111111111
